start,0,0,,,
goal,5,5,,,
0,0,0,1,0,0
0,0,0,1,0,0
0,1,0,0,1,0
0,0,0,0,0,0
0,0,0,0,1,0
0,0,0,0,0,0
